
F 0,0,0
NO ./textures/haru_north.xpm
EA ./textures/odeok_east.xpm

SO ./textures/haru_south.xpm
WE ./textures/odeok_west.xpm
C 255,255,255

1111111111111
1111100011111
1111100011111
1111100011111
1111101011111
110000S000001
1111100011111
1111110111111
1111100011111
1111100011111
1111111111111