
F 0,0,0
NO ./textures/north_text.xpm
EA ./textures/east_text.xpm

SO ./textures/south_text.xpm
WE ./textures/west_text.xpm
C 255,255,255

1111111111111
1111100011111
1111100011111
1111100011111
1111100011111
110110N011001
1111100011111
1111100011111
1111100011111
1111100011111
1111111111111