
F 0,0,1
NO ./textures/haru_north.xpm
EA ./textures/odeok_east.xpm

SO ./textures/haru_south.xpm
WE ./textures/odeok_west.xpm
C 0,0,111

1111111111111
1111100011111
1111100011111
1111100011111
1111101111111
1100001N0001101
111111111111111