
F ,,1
NO ./textures/haru_north.xpm
EA ./textures/odeok_east.xpm





SO ./textures/haru_south.xpm
WE ./textures/odeok_west.xpm
C 0,0,111

    1111111
   111111111
 111111111001
1000000000S101
 111111110101
  1111111111
