
F 0,0,1
NO ./textures/haru_north.xpm
EA ./textures/odeok_east.xpm

SO ./textures/haru_south.xpm
WE ./textures/odeok_west.xpm
C 0,0,111

1111111111111
1111111111111
1000000000011111
111111111111111S1
11111111111111111