
F 0,0,0
NO ./textures/mossy.xpm
EA ./textures/pillar.xpm

SO ./textures/redbrick.xpm
WE ./textures/wood.xpm
C 255,255,255

1111111111111
1111100011111
1111100011111
1111110111111
1111100011111
110000N000001
1111100011111
1111100011111
1111100011111
1111100011111
1111111111111