
F 123,123,255
NO ./textures/n.xpm
EA ./textures/e.xpm

SO ./textures/s.xpm
WE ./textures/w.xpm
C 255,90,1

1111111111111
1111100011111
110110N011001
1111111111111